----------------------------------------------------------------------------------------
-                                                                           ------------
-                                                      #                   #------------
-           x          ?                               --         ----     -------------
-           ---       --                        ---             x           ------------
-                 #            -----                 #?      ----           ------------
-     ----        -                                  --                   F ------------
-  @                  ----            #    ----                          ---------------
-  -                                 --                                     ------------
-ooooooooooooooooooooooooooooooooooooooooooooooooooooooooooooooooooooooooooo------------
----------------------------------------------------------------------------------------